1555182308,425,392,33,Cash,"[['Sandwich', 'Hamburger', 425, {'Lettuce': 0, 'Tomatoes': 0, 'Pickles': 0, 'Onions': 0, 'Another': 0, 'Thing': 0}, [], {'register': 0, 'status': 1}, ['', '', 0, {}, [], {'register': 0, 'status': 1}], ['', '', 0, {}, [], {'register': 0, 'status': 1}]]]"
1555184125,895,825,70,Cash,"[['Sandwich', 'Hamburger', 425, {'Lettuce': 0, 'Tomatoes': 0, 'Pickles': 0, 'Onions': 0, 'Another': 0, 'Thing': 0}, [], {'register': 0, 'status': 1}, ['', '', 0, {}, [], {'register': 0, 'status': 1}], ['', '', 0, {}, [], {'register': 0, 'status': 1}]], ['Sandwich', 'Cheeseburger', 470, {}, [], {'register': 0, 'status': 1}, ['', '', 0, {}, [], {'register': 0, 'status': 1}], ['', '', 0, {}, [], {'register': 0, 'status': 1}]]]"
1555184138,830,765,65,Cash,"[['Sandwich', 'Hamburger', 425, {'Lettuce': 0, 'Tomatoes': 0, 'Pickles': 0, 'Onions': 0, 'Another': 0, 'Thing': 0}, [], {'register': 0, 'status': 1}, ['Sides', 'Dinner Salad', 305, {}, [], {'register': 0, 'status': 1}], ['Drinks', 'Bottled Water', 100, {}, [], {'register': 1, 'status': 1}]]]"
1555184140,425,392,33,Cash,"[['Sandwich', 'Hamburger', 425, {'Lettuce': 0, 'Tomatoes': 0, 'Pickles': 0, 'Onions': 0, 'Another': 0, 'Thing': 0}, [], {'register': 0, 'status': 1}, ['', '', 0, {}, [], {'register': 0, 'status': 1}], ['', '', 0, {}, [], {'register': 0, 'status': 1}]]]"
1555184256,425,392,33,Cash,"[['Sandwich', 'Hamburger', 425, {'Lettuce': 0, 'Tomatoes': 0, 'Pickles': 0, 'Onions': 0, 'Another': 0, 'Thing': 0}, [], {'register': 0, 'status': 1}, ['', '', 0, {}, [], {'register': 0, 'status': 1}], ['', '', 0, {}, [], {'register': 0, 'status': 1}]]]"
1555184257,425,392,33,Cash,"[['Sandwich', 'Hamburger', 425, {'Lettuce': 0, 'Tomatoes': 0, 'Pickles': 0, 'Onions': 0, 'Another': 0, 'Thing': 0}, [], {'register': 0, 'status': 1}, ['', '', 0, {}, [], {'register': 0, 'status': 1}], ['', '', 0, {}, [], {'register': 0, 'status': 1}]]]"
1555184259,425,392,33,Cash,"[['Sandwich', 'Hamburger', 425, {'Lettuce': 0, 'Tomatoes': 0, 'Pickles': 0, 'Onions': 0, 'Another': 0, 'Thing': 0}, [], {'register': 0, 'status': 1}, ['', '', 0, {}, [], {'register': 0, 'status': 1}], ['', '', 0, {}, [], {'register': 0, 'status': 1}]]]"
1555184264,425,392,33,Cash,"[['Sandwich', 'Hamburger', 425, {'Lettuce': 0, 'Tomatoes': 0, 'Pickles': 0, 'Onions': 0, 'Another': 0, 'Thing': 0}, [], {'register': 0, 'status': 1}, ['', '', 0, {}, [], {'register': 0, 'status': 1}], ['', '', 0, {}, [], {'register': 0, 'status': 1}]]]"
1555184272,425,392,33,Cash,"[['Sandwich', 'Hamburger', 425, {'Lettuce': 0, 'Tomatoes': 0, 'Pickles': 0, 'Onions': 0, 'Another': 0, 'Thing': 0}, [], {'register': 0, 'status': 1}, ['', '', 0, {}, [], {'register': 0, 'status': 1}], ['', '', 0, {}, [], {'register': 0, 'status': 1}]]]"
1555184274,425,392,33,Cash,"[['Sandwich', 'Hamburger', 425, {'Lettuce': 0, 'Tomatoes': 0, 'Pickles': 0, 'Onions': 0, 'Another': 0, 'Thing': 0}, [], {'register': 0, 'status': 1}, ['', '', 0, {}, [], {'register': 0, 'status': 1}], ['', '', 0, {}, [], {'register': 0, 'status': 1}]]]"
1555184275,425,392,33,Cash,"[['Sandwich', 'Hamburger', 425, {'Lettuce': 0, 'Tomatoes': 0, 'Pickles': 0, 'Onions': 0, 'Another': 0, 'Thing': 0}, [], {'register': 0, 'status': 1}, ['', '', 0, {}, [], {'register': 0, 'status': 1}], ['', '', 0, {}, [], {'register': 0, 'status': 1}]]]"
1555184276,425,392,33,Cash,"[['Sandwich', 'Hamburger', 425, {'Lettuce': 0, 'Tomatoes': 0, 'Pickles': 0, 'Onions': 0, 'Another': 0, 'Thing': 0}, [], {'register': 0, 'status': 1}, ['', '', 0, {}, [], {'register': 0, 'status': 1}], ['', '', 0, {}, [], {'register': 0, 'status': 1}]]]"
1555184276,425,392,33,Cash,"[['Sandwich', 'Hamburger', 425, {'Lettuce': 0, 'Tomatoes': 0, 'Pickles': 0, 'Onions': 0, 'Another': 0, 'Thing': 0}, [], {'register': 0, 'status': 1}, ['', '', 0, {}, [], {'register': 0, 'status': 1}], ['', '', 0, {}, [], {'register': 0, 'status': 1}]]]"
1555184401,425,392,33,Cash,"[['Sandwich', 'Hamburger', 425, {'Lettuce': 0, 'Tomatoes': 0, 'Pickles': 0, 'Onions': 0, 'Another': 0, 'Thing': 0}, [], {'register': 0, 'status': 1}, ['', '', 0, {}, [], {'register': 0, 'status': 1}], ['', '', 0, {}, [], {'register': 0, 'status': 1}]]]"
1555184404,470,433,37,Cash,"[['Sandwich', 'Cheeseburger', 470, {}, [], {'register': 0, 'status': 1}, ['', '', 0, {}, [], {'register': 0, 'status': 1}], ['', '', 0, {}, [], {'register': 0, 'status': 1}]]]"
1555184406,425,392,33,Cash,"[['Sandwich', 'Hamburger', 425, {'Lettuce': 0, 'Tomatoes': 0, 'Pickles': 0, 'Onions': 0, 'Another': 0, 'Thing': 0}, [], {'register': 0, 'status': 1}, ['', '', 0, {}, [], {'register': 0, 'status': 1}], ['', '', 0, {}, [], {'register': 0, 'status': 1}]]]"
1555184409,425,392,33,Cash,"[['Sandwich', 'Hamburger', 425, {'Lettuce': 0, 'Tomatoes': 0, 'Pickles': 0, 'Onions': 0, 'Another': 0, 'Thing': 0}, [], {'register': 0, 'status': 1}, ['', '', 0, {}, [], {'register': 0, 'status': 1}], ['', '', 0, {}, [], {'register': 0, 'status': 1}]]]"
1555184412,425,392,33,Cash,"[['Sandwich', 'Hamburger', 425, {'Lettuce': 0, 'Tomatoes': 0, 'Pickles': 0, 'Onions': 0, 'Another': 0, 'Thing': 0}, [], {'register': 0, 'status': 1}, ['', '', 0, {}, [], {'register': 0, 'status': 1}], ['', '', 0, {}, [], {'register': 0, 'status': 1}]]]"
1555184435,895,825,70,Cash,"[['Sandwich', 'Hamburger', 425, {'Lettuce': 0, 'Tomatoes': 0, 'Pickles': 0, 'Onions': 0, 'Another': 0, 'Thing': 0}, [], {'register': 0, 'status': 1}, ['', '', 0, {}, [], {'register': 0, 'status': 1}], ['', '', 0, {}, [], {'register': 0, 'status': 1}]], ['Sandwich', 'Cheeseburger', 470, {}, [], {'register': 0, 'status': 1}, ['', '', 0, {}, [], {'register': 0, 'status': 1}], ['', '', 0, {}, [], {'register': 0, 'status': 1}]]]"
1555184441,425,392,33,Cash,"[['Sandwich', 'Hamburger', 425, {'Lettuce': 0, 'Tomatoes': 0, 'Pickles': 0, 'Onions': 0, 'Another': 0, 'Thing': 0}, [], {'register': 0, 'status': 1}, ['', '', 0, {}, [], {'register': 0, 'status': 1}], ['', '', 0, {}, [], {'register': 0, 'status': 1}]]]"
1555184660,425,392,33,Cash,"[['Sandwich', 'Hamburger', 425, {'Lettuce': 0, 'Tomatoes': 0, 'Pickles': 0, 'Onions': 0, 'Another': 0, 'Thing': 0}, [], {'register': 0, 'status': 1}, ['', '', 0, {}, [], {'register': 0, 'status': 1}], ['', '', 0, {}, [], {'register': 0, 'status': 1}]]]"
1555184660,425,392,33,Cash,"[['Sandwich', 'Hamburger', 425, {'Lettuce': 0, 'Tomatoes': 0, 'Pickles': 0, 'Onions': 0, 'Another': 0, 'Thing': 0}, [], {'register': 0, 'status': 1}, ['', '', 0, {}, [], {'register': 0, 'status': 1}], ['', '', 0, {}, [], {'register': 0, 'status': 1}]]]"
1555184661,425,392,33,Cash,"[['Sandwich', 'Hamburger', 425, {'Lettuce': 0, 'Tomatoes': 0, 'Pickles': 0, 'Onions': 0, 'Another': 0, 'Thing': 0}, [], {'register': 0, 'status': 1}, ['', '', 0, {}, [], {'register': 0, 'status': 1}], ['', '', 0, {}, [], {'register': 0, 'status': 1}]]]"
1555184662,425,392,33,Cash,"[['Sandwich', 'Hamburger', 425, {'Lettuce': 0, 'Tomatoes': 0, 'Pickles': 0, 'Onions': 0, 'Another': 0, 'Thing': 0}, [], {'register': 0, 'status': 1}, ['', '', 0, {}, [], {'register': 0, 'status': 1}], ['', '', 0, {}, [], {'register': 0, 'status': 1}]]]"
1555184663,425,392,33,Cash,"[['Sandwich', 'Hamburger', 425, {'Lettuce': 0, 'Tomatoes': 0, 'Pickles': 0, 'Onions': 0, 'Another': 0, 'Thing': 0}, [], {'register': 0, 'status': 1}, ['', '', 0, {}, [], {'register': 0, 'status': 1}], ['', '', 0, {}, [], {'register': 0, 'status': 1}]]]"
1555185090,425,392,33,Cash,"[['Sandwich', 'Hamburger', 425, {'Lettuce': 0, 'Tomatoes': 0, 'Pickles': 0, 'Onions': 0, 'Another': 0, 'Thing': 0}, [], {'register': 0, 'status': 1}, ['', '', 0, {}, [], {'register': 0, 'status': 1}], ['', '', 0, {}, [], {'register': 0, 'status': 1}]]]"
1555185091,425,392,33,Cash,"[['Sandwich', 'Hamburger', 425, {'Lettuce': 0, 'Tomatoes': 0, 'Pickles': 0, 'Onions': 0, 'Another': 0, 'Thing': 0}, [], {'register': 0, 'status': 1}, ['', '', 0, {}, [], {'register': 0, 'status': 1}], ['', '', 0, {}, [], {'register': 0, 'status': 1}]]]"
1555185092,895,825,70,Cash,"[['Sandwich', 'Hamburger', 425, {'Lettuce': 0, 'Tomatoes': 0, 'Pickles': 0, 'Onions': 0, 'Another': 0, 'Thing': 0}, [], {'register': 0, 'status': 1}, ['', '', 0, {}, [], {'register': 0, 'status': 1}], ['', '', 0, {}, [], {'register': 0, 'status': 1}]], ['Sandwich', 'Cheeseburger', 470, {}, [], {'register': 0, 'status': 1}, ['', '', 0, {}, [], {'register': 0, 'status': 1}], ['', '', 0, {}, [], {'register': 0, 'status': 1}]]]"
1555185094,895,825,70,Cash,"[['Sandwich', 'Hamburger', 425, {'Lettuce': 0, 'Tomatoes': 0, 'Pickles': 0, 'Onions': 0, 'Another': 0, 'Thing': 0}, [], {'register': 0, 'status': 1}, ['', '', 0, {}, [], {'register': 0, 'status': 1}], ['', '', 0, {}, [], {'register': 0, 'status': 1}]], ['Sandwich', 'Cheeseburger', 470, {}, [], {'register': 0, 'status': 1}, ['', '', 0, {}, [], {'register': 0, 'status': 1}], ['', '', 0, {}, [], {'register': 0, 'status': 1}]]]"
1555185100,895,825,70,Cash,"[['Sandwich', 'Hamburger', 425, {'Lettuce': 0, 'Tomatoes': 0, 'Pickles': 0, 'Onions': 0, 'Another': 0, 'Thing': 0}, [], {'register': 0, 'status': 1}, ['', '', 0, {}, [], {'register': 0, 'status': 1}], ['', '', 0, {}, [], {'register': 0, 'status': 1}]], ['Sandwich', 'Cheeseburger', 470, {}, [], {'register': 0, 'status': 1}, ['', '', 0, {}, [], {'register': 0, 'status': 1}], ['', '', 0, {}, [], {'register': 0, 'status': 1}]]]"
1555185430,425,392,33,Cash,"[['Sandwich', 'Hamburger', 425, {'Lettuce': 0, 'Tomatoes': 0, 'Pickles': 0, 'Onions': 0, 'Another': 0, 'Thing': 0}, [], {'register': 0, 'status': 1}, ['', '', 0, {}, [], {'register': 0, 'status': 1}], ['', '', 0, {}, [], {'register': 0, 'status': 1}]]]"
1555185566,745,686,59,Check,"[['Sandwich', 'Hamburger', 425, {'Lettuce': 0, 'Tomatoes': 0, 'Pickles': 0, 'Onions': 0, 'Another': 0, 'Thing': 0}, [], {'register': 0, 'status': 1}, ['Sides', 'French Fries', 220, {}, [], {'status': 1}], ['Drinks', 'Bottled Water', 100, {}, [], {'status': 1}]]]"
1555185568,2080,1916,164,Cash,"[['Sandwich', 'Cheeseburger', 470, {}, [], {'register': 0, 'status': 1}, ['Sides', 'French Fries', 220, {}, [], {'status': 1}], ['Drinks', 'Bottled Water', 100, {}, [], {'status': 1}]], ['Sandwich', 'Hamburger', 425, {'Lettuce': 0, 'Tomatoes': 0, 'Pickles': 0, 'Onions': 0, 'Another': 0, 'Thing': 0}, ['Lettuce', 'Tomatoes'], {'register': 0, 'status': 1}, ['Sides', 'French Fries', 220, {}, [], {'status': 1}], ['Drinks', 'Tea', 220, {}, [], {'status': 1}]], ['Sandwich', 'Hamburger', 425, {'Lettuce': 0, 'Tomatoes': 0, 'Pickles': 0, 'Onions': 0, 'Another': 0, 'Thing': 0}, [], {'register': 0, 'status': 1}, ['', '', 0, {}, [], {'status': 1}], ['', '', 0, {}, [], {'status': 1}]]]"
1555188634,425,392,33,Cash,"[['Sandwich', 'Hamburger', 425, {'Lettuce': 0, 'Tomatoes': 0, 'Pickles': 0, 'Onions': 0, 'Another': 0, 'Thing': 0}, [], {'register': 0, 'status': 1}, ['', '', 0, {}, [], {'register': 0, 'status': 1}], ['', '', 0, {}, [], {'register': 0, 'status': 1}]]]"
1555188928,425,392,33,Cash,"[['Sandwich', 'Hamburger', 425, {'Lettuce': 0, 'Tomatoes': 0, 'Pickles': 0, 'Onions': 0, 'Another': 0, 'Thing': 0}, [], {'register': 0, 'status': 1}, ['', '', 0, {}, [], {'register': 0, 'status': 1}], ['', '', 0, {}, [], {'register': 0, 'status': 1}]]]"
1555189103,645,594,51,Check,"[['Sandwich', 'Hamburger', 425, {'Lettuce': 0, 'Tomatoes': 0, 'Pickles': 0, 'Onions': 0, 'Another': 0, 'Thing': 0}, [], {'register': 0, 'status': 1}, ['', '', 0, {}, [], {'register': 0, 'status': 1}], ['Drinks', 'Tea', 220, {}, [], {'register': 1, 'status': 1}]]]"
1555189241,425,392,33,Cash,"[['Sandwich', 'Hamburger', 425, {'Lettuce': 0, 'Tomatoes': 0, 'Pickles': 0, 'Onions': 0, 'Another': 0, 'Thing': 0}, [], {'register': 0, 'status': 1}, ['', '', 0, {}, [], {'register': 0, 'status': 1}], ['', '', 0, {}, [], {'register': 0, 'status': 1}]]]"
1555189469,425,392,33,Cash,"[['Sandwich', 'Hamburger', 425, {'Lettuce': 0, 'Tomatoes': 0, 'Pickles': 0, 'Onions': 0, 'Another': 0, 'Thing': 0}, [], {'register': 0, 'status': 1}, ['', '', 0, {}, [], {'register': 0, 'status': 1}], ['', '', 0, {}, [], {'register': 0, 'status': 1}]]]"
1555189516,425,392,33,Cash,"[['Sandwich', 'Hamburger', 425, {'Lettuce': 0, 'Tomatoes': 0, 'Pickles': 0, 'Onions': 0, 'Another': 0, 'Thing': 0}, [], {'register': 0, 'status': 1}, ['', '', 0, {}, [], {'register': 0, 'status': 1}], ['', '', 0, {}, [], {'register': 0, 'status': 1}]]]"
1555189531,425,392,33,Cash,"[['Sandwich', 'Hamburger', 425, {'Lettuce': 0, 'Tomatoes': 0, 'Pickles': 0, 'Onions': 0, 'Another': 0, 'Thing': 0}, [], {'register': 0, 'status': 1}, ['', '', 0, {}, [], {'register': 0, 'status': 1}], ['', '', 0, {}, [], {'register': 0, 'status': 1}]]]"
1555189547,745,686,59,Cash,"[['Sandwich', 'Hamburger', 425, {'Lettuce': 0, 'Tomatoes': 0, 'Pickles': 0, 'Onions': 0, 'Another': 0, 'Thing': 0}, [], {'register': 0, 'status': 1}, ['Sides', 'French Fries', 220, {}, [], {'register': 0, 'status': 1}], ['Drinks', 'Bottled Water', 100, {}, [], {'register': 1, 'status': 1}]]]"
1555189601,425,392,33,Cash,"[['Sandwich', 'Hamburger', 425, {'Lettuce': 0, 'Tomatoes': 0, 'Pickles': 0, 'Onions': 0, 'Another': 0, 'Thing': 0}, [], {'register': 0, 'status': 1}, ['', '', 0, {}, [], {'register': 0, 'status': 1}], ['', '', 0, {}, [], {'register': 0, 'status': 1}]]]"
1555189609,950,875,75,Cash,"[['Sandwich', 'Hamburger', 425, {'Lettuce': 0, 'Tomatoes': 0, 'Pickles': 0, 'Onions': 0, 'Another': 0, 'Thing': 0}, [], {'register': 0, 'status': 1}, ['Sides', 'Dinner Salad', 305, {}, [], {'register': 0, 'status': 1}], ['Drinks', 'Tea', 220, {}, [], {'register': 1, 'status': 1}]]]"
1555189613,780,719,61,Cash,"[['Sandwich', 'Hamburger', 425, {'Lettuce': 0, 'Tomatoes': 0, 'Pickles': 0, 'Onions': 0, 'Another': 0, 'Thing': 0}, [], {'register': 0, 'status': 1}, ['Sides', 'Dinner Salad', 305, {}, [], {'register': 0, 'status': 1}], ['Drinks', 'Water cup', 50, {}, [], {'register': 1, 'status': 1}]]]"
1555190074,425,392,33,Cash,"[['Sandwich', 'Hamburger', 425, {'Lettuce': 0, 'Tomatoes': 0, 'Pickles': 0, 'Onions': 0, 'Another': 0, 'Thing': 0}, [], {'register': 0, 'status': 1}, ['', '', 0, {}, [], {'register': 0, 'status': 1}], ['', '', 0, {}, [], {'register': 0, 'status': 1}]]]"
1555190092,1160,1069,91,Cash,"[['Sandwich', 'Hamburger', 425, {'Lettuce': 0, 'Tomatoes': 0, 'Pickles': 0, 'Onions': 0, 'Another': 0, 'Thing': 0}, [], {'register': 0, 'status': 1}, ['Sides', 'Chef Salad', 635, {}, [], {'register': 0, 'status': 1}], ['Drinks', 'Bottled Water', 100, {}, [], {'register': 1, 'status': 1}]]]"
1555190182,425,392,33,Cash,"[['Sandwich', 'Hamburger', 425, {'Lettuce': 0, 'Tomatoes': 0, 'Pickles': 0, 'Onions': 0, 'Another': 0, 'Thing': 0}, [], {'register': 0, 'status': 1}, ['', '', 0, {}, [], {'register': 0, 'status': 1}], ['', '', 0, {}, [], {'register': 0, 'status': 1}]]]"
1555190183,425,392,33,Cash,"[['Sandwich', 'Hamburger', 425, {'Lettuce': 0, 'Tomatoes': 0, 'Pickles': 0, 'Onions': 0, 'Another': 0, 'Thing': 0}, [], {'register': 0, 'status': 1}, ['', '', 0, {}, [], {'register': 0, 'status': 1}], ['', '', 0, {}, [], {'register': 0, 'status': 1}]]]"
1555190393,425,392,33,Cash,"[['Sandwich', 'Hamburger', 425, {'Lettuce': 0, 'Tomatoes': 0, 'Pickles': 0, 'Onions': 0, 'Another': 0, 'Thing': 0}, [], {'register': 0, 'status': 1}, ['', '', 0, {}, [], {'register': 0, 'status': 1}], ['', '', 0, {}, [], {'register': 0, 'status': 1}]]]"
1555190788,425,392,33,Cash,"[['Sandwich', 'Hamburger', 425, {'Lettuce': 0, 'Tomatoes': 0, 'Pickles': 0, 'Onions': 0, 'Another': 0, 'Thing': 0}, [], {'register': 0, 'status': 1}, ['', '', 0, {}, [], {'register': 0, 'status': 1}], ['', '', 0, {}, [], {'register': 0, 'status': 1}]]]"
1555190868,425,392,33,Cash,"[['Sandwich', 'Hamburger', 425, {'Lettuce': 0, 'Tomatoes': 0, 'Pickles': 0, 'Onions': 0, 'Another': 0, 'Thing': 0}, [], {'register': 0, 'status': 1}, ['', '', 0, {}, [], {'register': 0, 'status': 1}], ['', '', 0, {}, [], {'register': 0, 'status': 1}]]]"
1555190897,425,392,33,Cash,"[['Sandwich', 'Hamburger', 425, {'Lettuce': 0, 'Tomatoes': 0, 'Pickles': 0, 'Onions': 0, 'Another': 0, 'Thing': 0}, [], {'register': 0, 'status': 1}, ['', '', 0, {}, [], {'register': 0, 'status': 1}], ['', '', 0, {}, [], {'register': 0, 'status': 1}]]]"
1555191463,895,825,70,Cash,"[['Sandwich', 'Hamburger', 425, {'Lettuce': 0, 'Tomatoes': 0, 'Pickles': 0, 'Onions': 0, 'Another': 0, 'Thing': 0}, [], {'register': 0, 'status': 1}, ['', '', 0, {}, [], {'register': 0, 'status': 1}], ['', '', 0, {}, [], {'register': 0, 'status': 1}]], ['Sandwich', 'Cheeseburger', 470, {}, [], {'register': 0, 'status': 1}, ['', '', 0, {}, [], {'register': 0, 'status': 1}], ['', '', 0, {}, [], {'register': 0, 'status': 1}]]]"
1555191472,850,783,67,Cash,"[['Sandwich', 'Hamburger', 425, {'Lettuce': 0, 'Tomatoes': 0, 'Pickles': 0, 'Onions': 0, 'Another': 0, 'Thing': 0}, [], {'register': 0, 'status': 1}, ['', '', 0, {}, [], {'register': 0, 'status': 1}], ['', '', 0, {}, [], {'register': 0, 'status': 1}]], ['Sandwich', 'Hamburger', 425, {'Lettuce': 0, 'Tomatoes': 0, 'Pickles': 0, 'Onions': 0, 'Another': 0, 'Thing': 0}, [], {'register': 0, 'status': 1}, ['', '', 0, {}, [], {'register': 0, 'status': 1}], ['', '', 0, {}, [], {'register': 0, 'status': 1}]]]"
1555191473,425,392,33,Cash,"[['Sandwich', 'Hamburger', 425, {'Lettuce': 0, 'Tomatoes': 0, 'Pickles': 0, 'Onions': 0, 'Another': 0, 'Thing': 0}, [], {'register': 0, 'status': 1}, ['', '', 0, {}, [], {'register': 0, 'status': 1}], ['', '', 0, {}, [], {'register': 0, 'status': 1}]]]"
1555191474,425,392,33,Check,"[['Sandwich', 'Hamburger', 425, {'Lettuce': 0, 'Tomatoes': 0, 'Pickles': 0, 'Onions': 0, 'Another': 0, 'Thing': 0}, [], {'register': 0, 'status': 1}, ['', '', 0, {}, [], {'register': 0, 'status': 1}], ['', '', 0, {}, [], {'register': 0, 'status': 1}]]]"
1555191569,425,392,33,Cash,"[['Sandwich', 'Hamburger', 425, {'Lettuce': 0, 'Tomatoes': 0, 'Pickles': 0, 'Onions': 0, 'Another': 0, 'Thing': 0}, [], {'register': 0, 'status': 1}, ['', '', 0, {}, [], {'register': 0, 'status': 1}], ['', '', 0, {}, [], {'register': 0, 'status': 1}]]]"
1555191571,470,433,37,Cash,"[['Sandwich', 'Cheeseburger', 470, {}, [], {'register': 0, 'status': 1}, ['', '', 0, {}, [], {'register': 0, 'status': 1}], ['', '', 0, {}, [], {'register': 0, 'status': 1}]]]"
1555191572,425,392,33,Cash,"[['Sandwich', 'Hamburger', 425, {'Lettuce': 0, 'Tomatoes': 0, 'Pickles': 0, 'Onions': 0, 'Another': 0, 'Thing': 0}, [], {'register': 0, 'status': 1}, ['', '', 0, {}, [], {'register': 0, 'status': 1}], ['', '', 0, {}, [], {'register': 0, 'status': 1}]]]"
1555191642,425,392,33,Cash,"[['Sandwich', 'Hamburger', 425, {'Lettuce': 0, 'Tomatoes': 0, 'Pickles': 0, 'Onions': 0, 'Another': 0, 'Thing': 0}, [], {'register': 0, 'status': 1}, ['', '', 0, {}, [], {'register': 0, 'status': 1}], ['', '', 0, {}, [], {'register': 0, 'status': 1}]]]"
1555191648,425,392,33,Cash,"[['Sandwich', 'Hamburger', 425, {'Lettuce': 0, 'Tomatoes': 0, 'Pickles': 0, 'Onions': 0, 'Another': 0, 'Thing': 0}, [], {'register': 0, 'status': 1}, ['', '', 0, {}, [], {'register': 0, 'status': 1}], ['', '', 0, {}, [], {'register': 0, 'status': 1}]]]"
1555191794,425,392,33,Cash,"[['Sandwich', 'Hamburger', 425, {'Lettuce': 0, 'Tomatoes': 0, 'Pickles': 0, 'Onions': 0, 'Another': 0, 'Thing': 0}, [], {'register': 0, 'status': 1}, ['', '', 0, {}, [], {'register': 0, 'status': 1}], ['', '', 0, {}, [], {'register': 0, 'status': 1}]]]"
1555191817,425,392,33,Cash,"[['Sandwich', 'Hamburger', 425, {'Lettuce': 0, 'Tomatoes': 0, 'Pickles': 0, 'Onions': 0, 'Another': 0, 'Thing': 0}, [], {'register': 0, 'status': 1}, ['', '', 0, {}, [], {'register': 0, 'status': 1}], ['', '', 0, {}, [], {'register': 0, 'status': 1}]]]"
1555263158,895,825,70,Cash,"[['Sandwich', 'Hamburger', 425, {'Lettuce': 0, 'Tomatoes': 0, 'Pickles': 0, 'Onions': 0, 'Another': 0, 'Thing': 0}, [], {'register': 0, 'status': 1}, ['', '', 0, {}, [], {'register': 0, 'status': 1}], ['', '', 0, {}, [], {'register': 0, 'status': 1}]], ['Sandwich', 'Cheeseburger', 470, {}, [], {'register': 0, 'status': 1}, ['', '', 0, {}, [], {'register': 0, 'status': 1}], ['', '', 0, {}, [], {'register': 0, 'status': 1}]]]"
1555263158,425,392,33,Cash,"[['Sandwich', 'Hamburger', 425, {'Lettuce': 0, 'Tomatoes': 0, 'Pickles': 0, 'Onions': 0, 'Another': 0, 'Thing': 0}, [], {'register': 0, 'status': 1}, ['', '', 0, {}, [], {'register': 0, 'status': 1}], ['', '', 0, {}, [], {'register': 0, 'status': 1}]]]"
1555263159,425,392,33,Cash,"[['Sandwich', 'Hamburger', 425, {'Lettuce': 0, 'Tomatoes': 0, 'Pickles': 0, 'Onions': 0, 'Another': 0, 'Thing': 0}, [], {'register': 0, 'status': 1}, ['', '', 0, {}, [], {'register': 0, 'status': 1}], ['', '', 0, {}, [], {'register': 0, 'status': 1}]]]"
1555263603,425,392,33,Cash,"[['Sandwich', 'Hamburger', 425, {'Lettuce': 0, 'Tomatoes': 0, 'Pickles': 0, 'Onions': 0, 'Another': 0, 'Thing': 0}, [], {'register': 0, 'status': 1}, ['', '', 0, {}, [], {'register': 0, 'status': 1}], ['', '', 0, {}, [], {'register': 0, 'status': 1}]]]"
1555263610,425,392,33,Cash,"[['Sandwich', 'Hamburger', 425, {'Lettuce': 0, 'Tomatoes': 0, 'Pickles': 0, 'Onions': 0, 'Another': 0, 'Thing': 0}, [], {'register': 0, 'status': 1}, ['', '', 0, {}, [], {'register': 0, 'status': 1}], ['', '', 0, {}, [], {'register': 0, 'status': 1}]]]"
1555263952,895,825,70,Cash,"[['Sandwich', 'Hamburger', 425, {'Lettuce': 0, 'Tomatoes': 0, 'Pickles': 0, 'Onions': 0, 'Another': 0, 'Thing': 0}, [], {'register': 0, 'status': 1}, ['', '', 0, {}, [], {'register': 0, 'status': 1}], ['', '', 0, {}, [], {'register': 0, 'status': 1}]], ['Sandwich', 'Cheeseburger', 470, {}, [], {'register': 0, 'status': 1}, ['', '', 0, {}, [], {'register': 0, 'status': 1}], ['', '', 0, {}, [], {'register': 0, 'status': 1}]]]"
1555264407,425,392,33,Cash,"[['Sandwich', 'Hamburger', 425, {'Lettuce': 0, 'Tomatoes': 0, 'Pickles': 0, 'Onions': 0, 'Another': 0, 'Thing': 0}, [], {'register': 0, 'status': 1}, ['', '', 0, {}, [], {'register': 0, 'status': 1}], ['', '', 0, {}, [], {'register': 0, 'status': 1}]]]"
1555264409,425,392,33,Check,"[['Sandwich', 'Hamburger', 425, {'Lettuce': 0, 'Tomatoes': 0, 'Pickles': 0, 'Onions': 0, 'Another': 0, 'Thing': 0}, [], {'register': 0, 'status': 1}, ['', '', 0, {}, [], {'register': 0, 'status': 1}], ['', '', 0, {}, [], {'register': 0, 'status': 1}]]]"
1555264503,895,825,70,Cash,"[['Sandwich', 'Hamburger', 425, {'Lettuce': 0, 'Tomatoes': 0, 'Pickles': 0, 'Onions': 0, 'Another': 0, 'Thing': 0}, [], {'register': 0, 'status': 1}, ['', '', 0, {}, [], {'register': 0, 'status': 1}], ['', '', 0, {}, [], {'register': 0, 'status': 1}]], ['Sandwich', 'Cheeseburger', 470, {}, [], {'register': 0, 'status': 1}, ['', '', 0, {}, [], {'register': 0, 'status': 1}], ['', '', 0, {}, [], {'register': 0, 'status': 1}]]]"
1555264543,425,392,33,Cash,"[['Sandwich', 'Hamburger', 425, {'Lettuce': 0, 'Tomatoes': 0, 'Pickles': 0, 'Onions': 0, 'Another': 0, 'Thing': 0}, [], {'register': 0, 'status': 1}, ['', '', 0, {}, [], {'register': 0, 'status': 1}], ['', '', 0, {}, [], {'register': 0, 'status': 1}]]]"
1555264836,425,392,33,Check,"[['Sandwich', 'Hamburger', 425, {'Lettuce': 0, 'Tomatoes': 0, 'Pickles': 0, 'Onions': 0, 'Another': 0, 'Thing': 0}, [], {'register': 0, 'status': 1}, ['', '', 0, {}, [], {'register': 0, 'status': 1}], ['', '', 0, {}, [], {'register': 0, 'status': 1}]]]"
1555264924,425,392,33,Cash,"[['Sandwich', 'Hamburger', 425, {'Lettuce': 0, 'Tomatoes': 0, 'Pickles': 0, 'Onions': 0, 'Another': 0, 'Thing': 0}, [], {'register': 0, 'status': 1}, ['', '', 0, {}, [], {'register': 0, 'status': 1}], ['', '', 0, {}, [], {'register': 0, 'status': 1}]]]"
1555264930,425,392,33,Cash,"[['Sandwich', 'Hamburger', 425, {'Lettuce': 0, 'Tomatoes': 0, 'Pickles': 0, 'Onions': 0, 'Another': 0, 'Thing': 0}, [], {'register': 0, 'status': 1}, ['', '', 0, {}, [], {'register': 0, 'status': 1}], ['', '', 0, {}, [], {'register': 0, 'status': 1}]]]"
1555264939,425,392,33,Cash,"[['Sandwich', 'Hamburger', 425, {'Lettuce': 0, 'Tomatoes': 0, 'Pickles': 0, 'Onions': 0, 'Another': 0, 'Thing': 0}, [], {'register': 0, 'status': 1}, ['', '', 0, {}, [], {'register': 0, 'status': 1}], ['', '', 0, {}, [], {'register': 0, 'status': 1}]]]"
1555265012,425,392,33,Cash,"[['Sandwich', 'Hamburger', 425, {'Lettuce': 0, 'Tomatoes': 0, 'Pickles': 0, 'Onions': 0, 'Another': 0, 'Thing': 0}, [], {'register': 0, 'status': 1}, ['', '', 0, {}, [], {'register': 0, 'status': 1}], ['', '', 0, {}, [], {'register': 0, 'status': 1}]]]"
1555265018,425,392,33,Cash,"[['Sandwich', 'Hamburger', 425, {'Lettuce': 0, 'Tomatoes': 0, 'Pickles': 0, 'Onions': 0, 'Another': 0, 'Thing': 0}, [], {'register': 0, 'status': 1}, ['', '', 0, {}, [], {'register': 0, 'status': 1}], ['', '', 0, {}, [], {'register': 0, 'status': 1}]]]"
1555265020,425,392,33,Cash,"[['Sandwich', 'Hamburger', 425, {'Lettuce': 0, 'Tomatoes': 0, 'Pickles': 0, 'Onions': 0, 'Another': 0, 'Thing': 0}, [], {'register': 0, 'status': 1}, ['', '', 0, {}, [], {'register': 0, 'status': 1}], ['', '', 0, {}, [], {'register': 0, 'status': 1}]]]"
1555265022,425,392,33,Cash,"[['Sandwich', 'Hamburger', 425, {'Lettuce': 0, 'Tomatoes': 0, 'Pickles': 0, 'Onions': 0, 'Another': 0, 'Thing': 0}, [], {'register': 0, 'status': 1}, ['', '', 0, {}, [], {'register': 0, 'status': 1}], ['', '', 0, {}, [], {'register': 0, 'status': 1}]]]"
1555265022,425,392,33,Cash,"[['Sandwich', 'Hamburger', 425, {'Lettuce': 0, 'Tomatoes': 0, 'Pickles': 0, 'Onions': 0, 'Another': 0, 'Thing': 0}, [], {'register': 0, 'status': 1}, ['', '', 0, {}, [], {'register': 0, 'status': 1}], ['', '', 0, {}, [], {'register': 0, 'status': 1}]]]"
1555265022,425,392,33,Cash,"[['Sandwich', 'Hamburger', 425, {'Lettuce': 0, 'Tomatoes': 0, 'Pickles': 0, 'Onions': 0, 'Another': 0, 'Thing': 0}, [], {'register': 0, 'status': 1}, ['', '', 0, {}, [], {'register': 0, 'status': 1}], ['', '', 0, {}, [], {'register': 0, 'status': 1}]]]"
1555265022,425,392,33,Cash,"[['Sandwich', 'Hamburger', 425, {'Lettuce': 0, 'Tomatoes': 0, 'Pickles': 0, 'Onions': 0, 'Another': 0, 'Thing': 0}, [], {'register': 0, 'status': 1}, ['', '', 0, {}, [], {'register': 0, 'status': 1}], ['', '', 0, {}, [], {'register': 0, 'status': 1}]]]"
1555265022,425,392,33,Cash,"[['Sandwich', 'Hamburger', 425, {'Lettuce': 0, 'Tomatoes': 0, 'Pickles': 0, 'Onions': 0, 'Another': 0, 'Thing': 0}, [], {'register': 0, 'status': 1}, ['', '', 0, {}, [], {'register': 0, 'status': 1}], ['', '', 0, {}, [], {'register': 0, 'status': 1}]]]"
1555265023,425,392,33,Cash,"[['Sandwich', 'Hamburger', 425, {'Lettuce': 0, 'Tomatoes': 0, 'Pickles': 0, 'Onions': 0, 'Another': 0, 'Thing': 0}, [], {'register': 0, 'status': 1}, ['', '', 0, {}, [], {'register': 0, 'status': 1}], ['', '', 0, {}, [], {'register': 0, 'status': 1}]]]"
1555265290,425,392,33,Cash,"[['Sandwich', 'Hamburger', 425, {'Lettuce': 0, 'Tomatoes': 0, 'Pickles': 0, 'Onions': 0, 'Another': 0, 'Thing': 0}, [], {'register': 0, 'status': 1}, ['', '', 0, {}, [], {'register': 0, 'status': 1}], ['', '', 0, {}, [], {'register': 0, 'status': 1}]]]"
1555265291,425,392,33,Cash,"[['Sandwich', 'Hamburger', 425, {'Lettuce': 0, 'Tomatoes': 0, 'Pickles': 0, 'Onions': 0, 'Another': 0, 'Thing': 0}, [], {'register': 0, 'status': 1}, ['', '', 0, {}, [], {'register': 0, 'status': 1}], ['', '', 0, {}, [], {'register': 0, 'status': 1}]]]"
1555265292,895,825,70,Cash,"[['Sandwich', 'Hamburger', 425, {'Lettuce': 0, 'Tomatoes': 0, 'Pickles': 0, 'Onions': 0, 'Another': 0, 'Thing': 0}, [], {'register': 0, 'status': 1}, ['', '', 0, {}, [], {'register': 0, 'status': 1}], ['', '', 0, {}, [], {'register': 0, 'status': 1}]], ['Sandwich', 'Cheeseburger', 470, {}, [], {'register': 0, 'status': 1}, ['', '', 0, {}, [], {'register': 0, 'status': 1}], ['', '', 0, {}, [], {'register': 0, 'status': 1}]]]"
1555265929,425,392,33,Cash,"[['Sandwich', 'Hamburger', 425, {'Lettuce': 0, 'Tomatoes': 0, 'Pickles': 0, 'Onions': 0, 'Another': 0, 'Thing': 0}, [], {'register': 0, 'status': 1}, ['', '', 0, {}, [], {'register': 0, 'status': 1}], ['', '', 0, {}, [], {'register': 0, 'status': 1}]]]"
1555265942,425,392,33,Cash,"[['Sandwich', 'Hamburger', 425, {'Lettuce': 0, 'Tomatoes': 0, 'Pickles': 0, 'Onions': 0, 'Another': 0, 'Thing': 0}, [], {'register': 0, 'status': 1}, ['', '', 0, {}, [], {'register': 0, 'status': 1}], ['', '', 0, {}, [], {'register': 0, 'status': 1}]]]"
1555265959,425,392,33,Cash,"[['Sandwich', 'Hamburger', 425, {'Lettuce': 0, 'Tomatoes': 0, 'Pickles': 0, 'Onions': 0, 'Another': 0, 'Thing': 0}, [], {'register': 0, 'status': 1}, ['', '', 0, {}, [], {'register': 0, 'status': 1}], ['', '', 0, {}, [], {'register': 0, 'status': 1}]]]"
1555265964,425,392,33,Cash,"[['Sandwich', 'Hamburger', 425, {'Lettuce': 0, 'Tomatoes': 0, 'Pickles': 0, 'Onions': 0, 'Another': 0, 'Thing': 0}, [], {'register': 0, 'status': 1}, ['', '', 0, {}, [], {'register': 0, 'status': 1}], ['', '', 0, {}, [], {'register': 0, 'status': 1}]]]"
1555266652,425,392,33,Cash,"[['Sandwich', 'Hamburger', 425, {'Lettuce': 0, 'Tomatoes': 0, 'Pickles': 0, 'Onions': 0, 'Another': 0, 'Thing': 0}, [], {'register': 0, 'status': 1}, ['', '', 0, {}, [], {'register': 0, 'status': 1}], ['', '', 0, {}, [], {'register': 0, 'status': 1}]]]"
1555266972,425,392,33,Cash,"[['Sandwich', 'Hamburger', 425, {'Lettuce': 0, 'Tomatoes': 0, 'Pickles': 0, 'Onions': 0, 'Another': 0, 'Thing': 0}, [], {'register': 0, 'status': 1}, ['', '', 0, {}, [], {'register': 0, 'status': 1}], ['', '', 0, {}, [], {'register': 0, 'status': 1}]]]"
1555267479,1320,1216,104,Cash,"[['Sandwich', 'Hamburger', 425, {'Lettuce': 0, 'Tomatoes': 0, 'Pickles': 0, 'Onions': 0, 'Another': 0, 'Thing': 0}, [], {'register': 0, 'status': 1}, ['', '', 0, {}, [], {'register': 0, 'status': 1}], ['', '', 0, {}, [], {'register': 0, 'status': 1}]], ['Sandwich', 'Cheeseburger', 470, {}, [], {'register': 0, 'status': 1}, ['', '', 0, {}, [], {'register': 0, 'status': 1}], ['', '', 0, {}, [], {'register': 0, 'status': 1}]], ['Sandwich', 'Hamburger', 425, {'Lettuce': 0, 'Tomatoes': 0, 'Pickles': 0, 'Onions': 0, 'Another': 0, 'Thing': 0}, [], {'register': 0, 'status': 1}, ['', '', 0, {}, [], {'register': 0, 'status': 1}], ['', '', 0, {}, [], {'register': 0, 'status': 1}]]]"
1555268666,950,875,75,Cash,"[['Sandwich', 'Hamburger', 425, {'Lettuce': 0, 'Tomatoes': 0, 'Pickles': 0, 'Onions': 0, 'Another': 0, 'Thing': 0}, [], {'register': 0, 'status': 1}, ['Sides', 'Onion Rings', 305, {}, [], {'status': 1}], ['Drinks', 'Tea', 220, {}, [], {'status': 1}]]]"
1555268669,1665,1534,131,Cash,"[['Sandwich', 'Hamburger', 425, {'Lettuce': 0, 'Tomatoes': 0, 'Pickles': 0, 'Onions': 0, 'Another': 0, 'Thing': 0}, [], {'register': 0, 'status': 1}, ['Sides', 'French Fries', 220, {}, [], {'status': 1}], ['Drinks', 'Tea', 220, {}, [], {'status': 1}]], ['Sandwich', 'Hamburger', 425, {'Lettuce': 0, 'Tomatoes': 0, 'Pickles': 0, 'Onions': 0, 'Another': 0, 'Thing': 0}, [], {'register': 0, 'status': 1}, ['Sides', 'Tater Tots', 275, {}, [], {'status': 1}], ['Drinks', 'Bottled Water', 100, {}, [], {'status': 1}]]]"
1555268695,2515,2317,198,Cash,"[['Sandwich', 'Hamburger', 425, {'Lettuce': 0, 'Tomatoes': 0, 'Pickles': 0, 'Onions': 0, 'Another': 0, 'Thing': 0}, [], {'register': 0, 'status': 1}, ['Sides', 'Seasoned Fries', 275, {}, [], {'status': 1}], ['Drinks', 'Water cup', 50, {}, [], {'status': 1}]], ['Sandwich', 'Hamburger', 425, {'Lettuce': 0, 'Tomatoes': 0, 'Pickles': 0, 'Onions': 0, 'Another': 0, 'Thing': 0}, [], {'register': 0, 'status': 1}, ['Sides', 'Tater Tots', 275, {}, [], {'status': 1}], ['Drinks', 'Hot Chocolate', 200, {}, [], {'status': 1}]], ['Sandwich', 'Hamburger', 425, {'Lettuce': 0, 'Tomatoes': 0, 'Pickles': 0, 'Onions': 0, 'Another': 0, 'Thing': 0}, [], {'register': 0, 'status': 1}, ['Sides', 'French Fries', 220, {}, [], {'status': 1}], ['Drinks', 'Tea', 220, {}, [], {'status': 1}]]]"
1555268733,800,737,63,Cash,"[['Sandwich', 'Hamburger', 425, {'Lettuce': 0, 'Tomatoes': 0, 'Pickles': 0, 'Onions': 0, 'Another': 0, 'Thing': 0}, [], {'register': 0, 'status': 1}, ['Sides', 'Tater Tots', 275, {}, [], {'status': 1}], ['Drinks', 'Bottled Water', 100, {}, [], {'status': 1}]]]"
1555268733,750,691,59,Cash,"[['Sandwich', 'Hamburger', 425, {'Lettuce': 0, 'Tomatoes': 0, 'Pickles': 0, 'Onions': 0, 'Another': 0, 'Thing': 0}, [], {'register': 0, 'status': 1}, ['Sides', 'Tater Tots', 275, {}, [], {'status': 1}], ['Drinks', 'Water cup', 50, {}, [], {'status': 1}]]]"
1555268868,425,392,33,Cash,"[['Sandwich', 'Hamburger', 425, {'Lettuce': 0, 'Tomatoes': 0, 'Pickles': 0, 'Onions': 0, 'Another': 0, 'Thing': 0}, [], {'register': 0, 'status': 1}, ['', '', 0, {}, [], {'register': 0, 'status': 1}], ['', '', 0, {}, [], {'register': 0, 'status': 1}]]]"
1555268868,425,392,33,Cash,"[['Sandwich', 'Hamburger', 425, {'Lettuce': 0, 'Tomatoes': 0, 'Pickles': 0, 'Onions': 0, 'Another': 0, 'Thing': 0}, [], {'register': 0, 'status': 1}, ['', '', 0, {}, [], {'register': 0, 'status': 1}], ['', '', 0, {}, [], {'register': 0, 'status': 1}]]]"
1555268868,425,392,33,Cash,"[['Sandwich', 'Hamburger', 425, {'Lettuce': 0, 'Tomatoes': 0, 'Pickles': 0, 'Onions': 0, 'Another': 0, 'Thing': 0}, [], {'register': 0, 'status': 1}, ['', '', 0, {}, [], {'register': 0, 'status': 1}], ['', '', 0, {}, [], {'register': 0, 'status': 1}]]]"
1555268907,750,691,59,Cash,"[['Sandwich', 'Hamburger', 425, {'Lettuce': 0, 'Tomatoes': 0, 'Pickles': 0, 'Onions': 0, 'Another': 0, 'Thing': 0}, [], {'register': 0, 'status': 1}, ['Sides', 'Tater Tots', 275, {}, [], {'status': 1}], ['Drinks', 'Water cup', 50, {}, [], {'status': 1}]]]"
1555268913,425,392,33,Cash,"[['Sandwich', 'Hamburger', 425, {'Lettuce': 0, 'Tomatoes': 0, 'Pickles': 0, 'Onions': 0, 'Another': 0, 'Thing': 0}, [], {'register': 0, 'status': 1}, ['', '', 0, {}, [], {'register': 0, 'status': 1}], ['', '', 0, {}, [], {'register': 0, 'status': 1}]]]"
1555268925,920,848,72,Cash,"[['Sandwich', 'Hamburger', 425, {'Lettuce': 0, 'Tomatoes': 0, 'Pickles': 0, 'Onions': 0, 'Another': 0, 'Thing': 0}, [], {'register': 0, 'status': 1}, ['Sides', 'Tater Tots', 275, {}, [], {'status': 1}], ['Drinks', 'Tea', 220, {}, [], {'status': 1}]]]"
1555269571,830,765,65,Cash,"[['Sandwich', 'Hamburger', 425, {'Lettuce': 0, 'Tomatoes': 0, 'Pickles': 0, 'Onions': 0, 'Another': 0, 'Thing': 0}, [], {'register': 0, 'status': 1}, ['Sides', 'Dinner Salad', 305, {}, [], {'status': 1}], ['Drinks', 'Bottled Water', 100, {}, [], {'status': 1}]]]"
1555350404,425,392,33,Cash,"[['Sandwich', 'Hamburger', 425, {'Lettuce': 0, 'Tomatoes': 0, 'Pickles': 0, 'Onions': 0, 'Another': 0, 'Thing': 0}, [], {'register': 0, 'status': 1}, ['', '', 0, {}, [], {'register': 0, 'status': 1}], ['', '', 0, {}, [], {'register': 0, 'status': 1}]]]"
1555350407,895,825,70,Check,"[['Sandwich', 'Hamburger', 425, {'Lettuce': 0, 'Tomatoes': 0, 'Pickles': 0, 'Onions': 0, 'Another': 0, 'Thing': 0}, [], {'register': 0, 'status': 1}, ['', '', 0, {}, [], {'register': 0, 'status': 1}], ['', '', 0, {}, [], {'register': 0, 'status': 1}]], ['Sandwich', 'Cheeseburger', 470, {}, [], {'register': 0, 'status': 1}, ['', '', 0, {}, [], {'register': 0, 'status': 1}], ['', '', 0, {}, [], {'register': 0, 'status': 1}]]]"
1555350464,920,848,72,Check,"[['Sandwich', 'Hamburger', 425, {'Lettuce': 0, 'Tomatoes': 0, 'Pickles': 0, 'Onions': 0, 'Another': 0, 'Thing': 0}, [], {'register': 0, 'status': 1}, ['Sides', 'Tater Tots', 275, {}, [], {'status': 1}], ['Drinks', 'Tea', 220, {}, [], {'register': 1, 'status': 1}]]]"
1555350471,850,783,67,Cash,"[['Sandwich', 'Hamburger', 425, {'Lettuce': 0, 'Tomatoes': 0, 'Pickles': 0, 'Onions': 0, 'Another': 0, 'Thing': 0}, [], {'register': 0, 'status': 1}, ['', '', 0, {}, [], {'register': 0, 'status': 1}], ['', '', 0, {}, [], {'register': 0, 'status': 1}]], ['Sandwich', 'Hamburger', 425, {'Lettuce': 0, 'Tomatoes': 0, 'Pickles': 0, 'Onions': 0, 'Another': 0, 'Thing': 0}, [], {'register': 0, 'status': 1}, ['', '', 0, {}, [], {'register': 0, 'status': 1}], ['', '', 0, {}, [], {'register': 0, 'status': 1}]]]"
1555351708,745,686,59,Cash,"[['Sandwich', 'Hamburger', 425, {'Lettuce': 0, 'Tomatoes': 0, 'Pickles': 0, 'Onions': 0, 'Another': 0, 'Thing': 0}, [], {'register': 0, 'status': 1}, ['Sides', 'French Fries', 220, {}, [], {'status': 1}], ['Drinks', 'Bottled Water', 100, {}, [], {'status': 1}]]]"
1555351710,1665,1534,131,Cash,"[['Sandwich', 'Hamburger', 425, {'Lettuce': 0, 'Tomatoes': 0, 'Pickles': 0, 'Onions': 0, 'Another': 0, 'Thing': 0}, [], {'register': 0, 'status': 1}, ['Sides', 'Tater Tots', 275, {}, [], {'status': 1}], ['Drinks', 'Bottled Water', 100, {}, [], {'status': 1}]], ['Sandwich', 'Hamburger', 425, {'Lettuce': 0, 'Tomatoes': 0, 'Pickles': 0, 'Onions': 0, 'Another': 0, 'Thing': 0}, [], {'register': 0, 'status': 1}, ['Sides', 'French Fries', 220, {}, [], {'status': 1}], ['Drinks', 'Tea', 220, {}, [], {'status': 1}]]]"
1555351710,1390,1281,109,Cash,"[['Sandwich', 'Cheeseburger', 470, {}, [], {'register': 0, 'status': 1}, ['Sides', 'Tater Tots', 275, {}, [], {'status': 1}], ['Drinks', 'Tea', 220, {}, [], {'status': 1}]], ['Sandwich', 'Hamburger', 425, {'Lettuce': 0, 'Tomatoes': 0, 'Pickles': 0, 'Onions': 0, 'Another': 0, 'Thing': 0}, [], {'register': 0, 'status': 1}, ['', '', 0, {}, [], {'status': 1}], ['', '', 0, {}, [], {'status': 1}]]]"
1555351711,1700,1566,134,Cash,"[['Sandwich', 'Hamburger', 425, {'Lettuce': 0, 'Tomatoes': 0, 'Pickles': 0, 'Onions': 0, 'Another': 0, 'Thing': 0}, [], {'register': 0, 'status': 1}, ['', '', 0, {}, [], {'register': 0, 'status': 1}], ['', '', 0, {}, [], {'register': 0, 'status': 1}]], ['Sandwich', 'Hamburger', 425, {'Lettuce': 0, 'Tomatoes': 0, 'Pickles': 0, 'Onions': 0, 'Another': 0, 'Thing': 0}, [], {'register': 0, 'status': 1}, ['', '', 0, {}, [], {'register': 0, 'status': 1}], ['', '', 0, {}, [], {'register': 0, 'status': 1}]], ['Sandwich', 'Hamburger', 425, {'Lettuce': 0, 'Tomatoes': 0, 'Pickles': 0, 'Onions': 0, 'Another': 0, 'Thing': 0}, [], {'register': 0, 'status': 1}, ['', '', 0, {}, [], {'register': 0, 'status': 1}], ['', '', 0, {}, [], {'register': 0, 'status': 1}]], ['Sandwich', 'Hamburger', 425, {'Lettuce': 0, 'Tomatoes': 0, 'Pickles': 0, 'Onions': 0, 'Another': 0, 'Thing': 0}, [], {'register': 0, 'status': 1}, ['', '', 0, {}, [], {'register': 0, 'status': 1}], ['', '', 0, {}, [], {'register': 0, 'status': 1}]]]"
1555352813,425,392,33,Cash,"[['Sandwich', 'Hamburger', 425, {'Lettuce': 0, 'Tomatoes': 0, 'Pickles': 0, 'Onions': 0, 'Another': 0, 'Thing': 0}, [], {'register': 0, 'status': 1}, ['', '', 0, {}, [], {'register': 0, 'status': 1}], ['', '', 0, {}, [], {'register': 0, 'status': 1}]]]"
1555355248,320,295,25,Cash,"[['Dessert', 'Pie', 320, {}, [], {'register': 0, 'status': 1}, ['Sides', 'French Fries', 220, {}, [], {'register': 0, 'status': 1}], ['Drinks', 'Bottled Water', 100, {}, [], {'register': 1, 'status': 1}]]]"
1555355249,425,392,33,Cash,"[['Sandwich', 'Hamburger', 425, {'Lettuce': 0, 'Tomatoes': 0, 'Pickles': 0, 'Onions': 0, 'Another': 0, 'Thing': 0}, [], {'register': 0, 'status': 1}, ['', '', 0, {}, [], {'status': 1}], ['', '', 0, {}, [], {'status': 1}]]]"
1555355308,745,686,59,Cash,"[['Sandwich', 'Hamburger', 425, {'Lettuce': 0, 'Tomatoes': 0, 'Pickles': 0, 'Onions': 0, 'Another': 0, 'Thing': 0}, [], {'register': 0, 'status': 1}, ['Sides', 'French Fries', 220, {}, [], {'register': 0, 'status': 1}], ['Drinks', 'Bottled Water', 100, {}, [], {'register': 1, 'status': 1}]]]"
1555357339,920,848,72,Cash,"[['Sandwich', 'Hamburger', 425, {'Lettuce': 0, 'Tomatoes': 0, 'Pickles': 0, 'Onions': 0, 'Another': 0, 'Thing': 0}, [], {'register': 0, 'status': 1}, ['Sides', 'Tater Tots', 275, {}, [], {'register': 0, 'status': 1}], ['Drinks', 'Tea', 220, {}, [], {'register': 1, 'status': 1}]]]"
1555361731,920,848,72,Cash,"[['Sandwich', 'Hamburger', 425, {'Lettuce': 0, 'Tomatoes': 0, 'Pickles': 0, 'Onions': 0, 'Another': 0, 'Thing': 0}, [], {'register': 0, 'status': 1}, ['Sides', 'Tater Tots', 275, {}, [], {'register': 0, 'status': 1}], ['Drinks', 'Bottled Soda', 220, {}, [], {'register': 1, 'status': 1}]]]"
1555361740,950,875,75,Check,"[['Sandwich', 'Hamburger', 425, {'Lettuce': 0, 'Tomatoes': 0, 'Pickles': 0, 'Onions': 0, 'Another': 0, 'Thing': 0}, [], {'register': 0, 'status': 1}, ['Sides', 'Onion Rings', 305, {}, [], {'register': 0, 'status': 1}], ['Drinks', 'Tea', 220, {}, [], {'register': 1, 'status': 1}]]]"
1555361752,425,392,33,Cash,"[['Sandwich', 'Hamburger', 425, {'Lettuce': 0, 'Tomatoes': 0, 'Pickles': 0, 'Onions': 0, 'Another': 0, 'Thing': 0}, [], {'register': 0, 'status': 1}, ['', '', 0, {}, [], {'register': 0, 'status': 1}], ['', '', 0, {}, [], {'register': 0, 'status': 1}]]]"
1555361762,425,392,33,Cash,"[['Sandwich', 'Hamburger', 425, {'Lettuce': 0, 'Tomatoes': 0, 'Pickles': 0, 'Onions': 0, 'Another': 0, 'Thing': 0}, [], {'register': 0, 'status': 1}, ['', '', 0, {}, [], {'register': 0, 'status': 1}], ['', '', 0, {}, [], {'register': 0, 'status': 1}]]]"
1555361985,1550,1428,122,Cash,"[['Sandwich', 'Hamburger', 425, {'Lettuce': 0, 'Tomatoes': 0, 'Pickles': 0, 'Onions': 0, 'Another': 0, 'Thing': 0}, [], {'register': 0, 'status': 1}, ['', '', 0, {}, [], {'register': 0, 'status': 1}], ['', '', 0, {}, [], {'register': 0, 'status': 1}]], ['Sandwich', 'Cheeseburger', 470, {}, [], {'register': 0, 'status': 1}, ['', '', 0, {}, [], {'register': 0, 'status': 1}], ['', '', 0, {}, [], {'register': 0, 'status': 1}]], ['Sandwich', 'Double Cheeseburger', 655, {}, [], {'register': 0, 'status': 1}, ['', '', 0, {}, [], {'register': 0, 'status': 1}], ['', '', 0, {}, [], {'register': 0, 'status': 1}]]]"
